event_at,removed,observed,censored,entrance,at_risk
0.0,0,0,0,26752,26752
1.0,1820,1760,60,0,26752
2.0,792,754,38,0,24932
3.0,633,609,24,0,24140
4.0,483,461,22,0,23507
5.0,700,665,35,0,23024
6.0,629,603,26,0,22324
7.0,542,504,38,0,21695
8.0,492,462,30,0,21153
9.0,545,513,32,0,20661
10.0,462,431,31,0,20116
11.0,473,444,29,0,19654
12.0,466,442,24,0,19181
13.0,440,413,27,0,18715
14.0,468,432,36,0,18275
15.0,402,371,31,0,17807
16.0,399,373,26,0,17405
17.0,393,369,24,0,17006
18.0,391,363,28,0,16613
19.0,377,351,26,0,16222
20.0,380,353,27,0,15845
21.0,336,317,19,0,15465
22.0,290,263,27,0,15129
23.0,306,281,25,0,14839
24.0,323,291,32,0,14533
25.0,307,286,21,0,14210
26.0,331,312,19,0,13903
27.0,298,277,21,0,13572
28.0,281,260,21,0,13274
29.0,282,257,25,0,12993
30.0,255,239,16,0,12711
31.0,285,256,29,0,12456
32.0,277,247,30,0,12171
33.0,276,243,33,0,11894
34.0,229,211,18,0,11618
35.0,266,245,21,0,11389
36.0,233,218,15,0,11123
37.0,214,194,20,0,10890
38.0,230,217,13,0,10676
39.0,217,198,19,0,10446
40.0,197,175,22,0,10229
41.0,212,202,10,0,10032
42.0,217,199,18,0,9820
43.0,208,191,17,0,9603
44.0,211,194,17,0,9395
45.0,190,179,11,0,9184
46.0,213,197,16,0,8994
47.0,167,154,13,0,8781
48.0,191,178,13,0,8614
49.0,188,166,22,0,8423
50.0,158,142,16,0,8235
51.0,191,174,17,0,8077
52.0,174,152,22,0,7886
53.0,175,156,19,0,7712
54.0,153,136,17,0,7537
55.0,165,152,13,0,7384
56.0,148,137,11,0,7219
57.0,153,137,16,0,7071
58.0,131,118,13,0,6918
59.0,156,133,23,0,6787
60.0,137,124,13,0,6631
61.0,135,111,24,0,6494
62.0,134,121,13,0,6359
63.0,146,128,18,0,6225
64.0,131,116,15,0,6079
65.0,143,125,18,0,5948
66.0,144,130,14,0,5805
67.0,117,104,13,0,5661
68.0,109,89,20,0,5544
69.0,118,107,11,0,5435
70.0,104,93,11,0,5317
71.0,94,83,11,0,5213
72.0,122,114,8,0,5119
73.0,95,80,15,0,4997
74.0,113,101,12,0,4902
75.0,122,105,17,0,4789
76.0,92,83,9,0,4667
77.0,112,95,17,0,4575
78.0,84,76,8,0,4463
79.0,106,92,14,0,4379
80.0,91,81,10,0,4273
81.0,94,85,9,0,4182
82.0,78,77,1,0,4088
83.0,78,72,6,0,4010
84.0,102,91,11,0,3932
85.0,76,64,12,0,3830
86.0,71,67,4,0,3754
87.0,67,59,8,0,3683
88.0,62,54,8,0,3616
89.0,77,70,7,0,3554
90.0,64,58,6,0,3477
91.0,53,51,2,0,3413
92.0,64,59,5,0,3360
93.0,67,60,7,0,3296
94.0,56,51,5,0,3229
95.0,47,40,7,0,3173
96.0,46,42,4,0,3126
97.0,64,63,1,0,3080
98.0,57,53,4,0,3016
99.0,51,42,9,0,2959
100.0,55,52,3,0,2908
101.0,99,55,44,0,2853
102.0,76,53,23,0,2754
103.0,76,54,22,0,2678
104.0,91,61,30,0,2602
105.0,65,49,16,0,2511
106.0,63,52,11,0,2446
107.0,45,39,6,0,2383
108.0,43,35,8,0,2338
109.0,42,33,9,0,2295
110.0,61,47,14,0,2253
111.0,46,40,6,0,2192
112.0,39,34,5,0,2146
113.0,53,48,5,0,2107
114.0,54,43,11,0,2054
115.0,41,36,5,0,2000
116.0,49,43,6,0,1959
117.0,47,40,7,0,1910
118.0,41,36,5,0,1863
119.0,47,41,6,0,1822
120.0,43,35,8,0,1775
121.0,38,31,7,0,1732
122.0,40,35,5,0,1694
123.0,40,32,8,0,1654
124.0,42,34,8,0,1614
125.0,31,23,8,0,1572
126.0,22,19,3,0,1541
127.0,39,30,9,0,1519
128.0,31,27,4,0,1480
129.0,26,22,4,0,1449
130.0,23,18,5,0,1423
131.0,28,23,5,0,1400
132.0,30,23,7,0,1372
133.0,27,24,3,0,1342
134.0,23,19,4,0,1315
135.0,20,14,6,0,1292
136.0,34,24,10,0,1272
137.0,34,28,6,0,1238
138.0,35,31,4,0,1204
139.0,33,27,6,0,1169
140.0,25,20,5,0,1136
141.0,19,19,0,0,1111
142.0,22,17,5,0,1092
143.0,35,31,4,0,1070
144.0,29,25,4,0,1035
145.0,22,20,2,0,1006
146.0,24,19,5,0,984
147.0,16,12,4,0,960
148.0,21,17,4,0,944
149.0,22,18,4,0,923
150.0,17,14,3,0,901
151.0,23,15,8,0,884
152.0,22,17,5,0,861
153.0,21,17,4,0,839
154.0,25,20,5,0,818
155.0,20,10,10,0,793
156.0,17,14,3,0,773
157.0,11,7,4,0,756
158.0,22,14,8,0,745
159.0,13,11,2,0,723
160.0,12,10,2,0,710
161.0,18,16,2,0,698
162.0,18,13,5,0,680
163.0,14,10,4,0,662
164.0,15,11,4,0,648
165.0,12,8,4,0,633
166.0,11,8,3,0,621
167.0,16,15,1,0,610
168.0,18,18,0,0,594
169.0,11,8,3,0,576
170.0,12,11,1,0,565
171.0,6,5,1,0,553
172.0,3,2,1,0,547
173.0,8,7,1,0,544
174.0,12,9,3,0,536
175.0,11,8,3,0,524
176.0,7,6,1,0,513
177.0,19,17,2,0,506
178.0,15,13,2,0,487
179.0,11,8,3,0,472
180.0,9,8,1,0,461
181.0,8,8,0,0,452
182.0,3,3,0,0,444
183.0,13,8,5,0,441
184.0,7,5,2,0,428
185.0,6,4,2,0,421
186.0,8,6,2,0,415
187.0,6,6,0,0,407
188.0,9,7,2,0,401
189.0,7,6,1,0,392
190.0,5,1,4,0,385
191.0,5,5,0,0,380
192.0,7,6,1,0,375
193.0,11,10,1,0,368
194.0,4,4,0,0,357
195.0,8,7,1,0,353
196.0,7,7,0,0,345
197.0,12,12,0,0,338
198.0,7,6,1,0,326
199.0,2,1,1,0,319
200.0,10,8,2,0,317
201.0,20,8,12,0,307
202.0,13,9,4,0,287
203.0,7,5,2,0,274
204.0,14,6,8,0,267
205.0,8,5,3,0,253
206.0,10,8,2,0,245
207.0,11,10,1,0,235
208.0,6,5,1,0,224
209.0,5,4,1,0,218
210.0,3,2,1,0,213
211.0,5,5,0,0,210
212.0,7,6,1,0,205
213.0,1,1,0,0,198
214.0,7,6,1,0,197
215.0,4,2,2,0,190
216.0,4,4,0,0,186
217.0,4,3,1,0,182
218.0,7,5,2,0,178
219.0,2,2,0,0,171
220.0,5,4,1,0,169
221.0,3,3,0,0,164
222.0,4,4,0,0,161
223.0,5,3,2,0,157
224.0,7,6,1,0,152
225.0,4,4,0,0,145
226.0,2,2,0,0,141
227.0,9,9,0,0,139
228.0,2,2,0,0,130
229.0,1,1,0,0,128
231.0,3,2,1,0,127
232.0,4,3,1,0,124
233.0,6,5,1,0,120
234.0,2,2,0,0,114
235.0,2,2,0,0,112
236.0,5,3,2,0,110
237.0,2,1,1,0,105
238.0,3,3,0,0,103
240.0,2,2,0,0,100
241.0,3,3,0,0,98
242.0,1,0,1,0,95
243.0,5,3,2,0,94
244.0,2,2,0,0,89
245.0,2,1,1,0,87
247.0,1,0,1,0,85
248.0,1,0,1,0,84
249.0,1,0,1,0,83
250.0,1,1,0,0,82
251.0,2,2,0,0,81
252.0,1,1,0,0,79
254.0,3,2,1,0,78
255.0,4,3,1,0,75
257.0,2,2,0,0,71
258.0,1,1,0,0,69
259.0,3,3,0,0,68
260.0,3,2,1,0,65
261.0,2,2,0,0,62
262.0,2,1,1,0,60
263.0,2,1,1,0,58
264.0,1,1,0,0,56
265.0,1,0,1,0,55
268.0,2,2,0,0,54
269.0,1,1,0,0,52
271.0,3,3,0,0,51
272.0,1,1,0,0,48
275.0,2,1,1,0,47
276.0,3,2,1,0,45
278.0,2,2,0,0,42
279.0,2,1,1,0,40
281.0,1,0,1,0,38
282.0,1,1,0,0,37
286.0,1,0,1,0,36
288.0,1,1,0,0,35
291.0,1,1,0,0,34
292.0,2,2,0,0,33
294.0,1,1,0,0,31
295.0,1,1,0,0,30
300.0,2,1,1,0,29
303.0,2,1,1,0,27
305.0,1,1,0,0,25
310.0,1,1,0,0,24
311.0,1,0,1,0,23
312.0,2,1,1,0,22
314.0,1,1,0,0,20
318.0,1,1,0,0,19
320.0,2,2,0,0,18
330.0,2,1,1,0,16
334.0,2,2,0,0,14
335.0,2,1,1,0,12
336.0,1,0,1,0,10
337.0,1,0,1,0,9
338.0,1,1,0,0,8
341.0,1,1,0,0,7
365.0,1,1,0,0,6
366.0,1,0,1,0,5
375.0,1,1,0,0,4
376.0,1,1,0,0,3
381.0,1,1,0,0,2
401.0,1,0,1,0,1
